8
8
30
2
0
5
7
0 0 0 0 0 0 0 0 
0 1 1 1 1 1 1 0 
1 1 1 1 1 1 1 0  
0 1 1 1 1 1 1 0 
0 1 1 1 1 1 1 0  
0 1 1 1 1 1 1 1  
0 1 1 1 1 1 1 0  
0 0 0 0 0 0 0 0  