21
21
16
1
0
19
20
0 0 0 0 0 0 0 0 0 0 0 0 0 0 0 0 0 0 0 0 0 
1 1 0 1 1 1 1 1 1 1 0 1 1 1 1 1 1 1 1 1 0 
0 1 0 1 0 0 1 0 0 1 1 1 0 0 0 0 0 0 0 1 0 
0 1 0 1 0 0 0 0 0 1 0 0 0 1 1 1 1 0 0 1 0 
0 1 0 1 1 1 1 1 0 1 0 1 0 1 0 0 1 1 0 1 0 
0 1 0 1 1 0 0 1 0 1 0 1 0 1 0 0 0 1 0 1 0 
0 1 0 0 0 0 1 1 0 1 1 1 0 1 0 1 1 1 0 1 0 
0 1 0 1 1 1 0 1 0 0 1 0 0 1 0 1 0 1 0 1 0 
0 1 1 1 0 1 1 1 0 0 0 0 0 1 0 1 0 1 0 1 0 
0 1 0 0 0 1 0 0 1 1 1 1 0 1 0 0 1 1 0 1 0 
0 1 1 1 0 1 0 0 1 0 0 1 0 1 0 1 1 0 0 1 0 
0 0 0 0 0 1 1 0 1 0 0 1 0 1 0 0 1 1 1 0 0 
0 1 1 0 0 1 0 0 1 0 1 1 1 1 0 0 1 0 1 0 0 
0 0 1 1 1 1 0 0 1 0 1 0 0 0 0 1 1 0 1 1 0 
0 0 1 0 1 0 1 1 1 0 0 0 1 1 1 1 0 0 0 1 0 
0 1 1 0 1 1 1 0 0 1 1 1 1 0 0 0 0 0 0 1 0 
0 1 0 0 0 0 0 1 0 0 0 0 1 1 1 0 1 1 1 1 0 
0 1 0 1 1 1 0 1 1 1 1 1 0 0 1 0 1 0 0 0 0 
0 1 0 1 0 1 0 0 0 1 0 0 1 0 1 0 1 0 0 0 0 
0 1 1 1 0 1 1 1 1 1 0 1 1 1 1 0 1 1 1 1 1 
0 0 0 0 0 0 0 0 0 0 0 0 0 0 0 0 0 0 0 0 0 

